%%%%%%%%%%%%%%%%%%%%%
%                 . %
%                   %
%                   %
%                   %
%         P         %
%                   %
%                   %
%                   %
%                   %
%%%%%%%%%%%%%%%%%%%%%