%%%%%%%%%%%%%%%%%%%%%
%                   %
%                   %
%  .                %
%                   %
%         P         %
%                   %
%                   %
%                   %
%                   %
%%%%%%%%%%%%%%%%%%%%%