%%%%%%%%%%%%%%%%%%%%%
%                   %
%                   %
%                   %
%                   %
%         P         %
%                   %
%                   %
%                   %
%                .  %
%%%%%%%%%%%%%%%%%%%%%