%%%%%%%%%%%%%%%%%%%%%%%%%%%%%%%%%%%%%
%                                   %
%            %                      %
%            %                      %
%            %                      %
%            %                      %
%            %                      %
%            %      %               %
%            %      %               %
%            %      %               %
%            %      %               %
%            %      %               %
%            %      %               %
%            %      %              P%
%%%%%%%%%%%%%%      %%%%%%%%%%%%%%%%%
%            %                     .%
%            %                      %
%            %                      %
%                                   %
%                                   %
%                                   %
%                                   %
%%%%%%%%%%%%%%%%%%%%%%%%%%%%%%%%%%%%%